1111111111111111111111
1000000000000C00000001
1010101010101010101001
10C0000000000000000001
1010101010101010101001
1000000000C00000000001
1010101010101010101001
100000C0000P0000000001
1010101010101010101001
1000000000C00000000001
1010101010101010101001
10000000000000000C0001
1010101010101010101001
1000C0000000000000E001
1111111111111111111111
