1111111111111111
1C00000C00000C11
1011110111110P11
1000000C00000011
1011110111110E11
1C00000C00000C11
1111111111111111
